1111111111111111111111111111111111
1E0000m00000000C00M00C000000000001
1010010100100000101001000000010101
1010m1001m1m10100m100100000001m1m1
1P0000000C00C0000000000M00000000C1
1111111111111111111111111111111111